1111111111111111111111111111111111111
101X0001C000000C000C00010C000000C0001
100C0101111C11111000100100X0000110001
10111101C00000X0100010010000X00000001
10X0010100X0C00011000X011110111000111
10111101010000000C0000010C00100C00001
1010C00X011110111111110100001000X00C1
10100011000C000C00X0X101000P100X00111
1C1C1000C000X00100000101E000100C00001
1011111111111111101100010011C00000001
100C0X0C000000C0001C000C0000000X00X01
100000010C00C00100X000100110111100011
101111110X0X111100X00110001000C001001
100C00X000C0000000C0000X00100000010C1
1111111111111111111111111111111111111