111111111111111111111111111111111
1000C00C00C00C000C00000C000000C01
1CP000X01000000000X0C0000C000C001
101000100100000X01000111111100001
1001010C01000C000000C00001100C001
10X010000111X00C0000000X0010C0001
10000C00C00100000C0X0000001000C01
10C000X00111X0X0000000000010C0001
1000C000000C0011100C0010C00000001
10X0000C0C0010001C0001X000C00C001
10100C0010000X1110000110000100001
1X0100C00010001C00X00X10C000C0C01
1000100X00001000100011110X0101001
1010C0000C0C00C00X0C0000000C01001
100X000C010000C0010000E000C000101
1000C0010000C0000X00C00000C000001
111111111111111111111111111111111