111111111111111
1X1C10C001110C1
11C0100C0C00X01
1C000CX11110C01
101C010C0E1C0X1
10110C0X011XC01
1C0C01C0C0C0001
11CXC1111X111C1
1C0111P0C00C001
10C000C111110C1
1C1CXC0X0C00CX1
111111111111111