111111111111111111111111
1C01100X000C0000C0000X01
10X0001C110C101001110011
100011EXC0000C00C0X0C001
11C01011X01X00010000101
100110000100C00C00000C01
10X0001001C0101001110011
10C011X0C0000C00X0C00001
1001100P000C0X0000000C01
1C0000100100100X01010X01
1001100CX000000C00X00001
10C0001011C010100011C011
111111111111111111111111