1111111111111111
1C001C0X0C100001
1000X00C00001C01
10P11001101C0111
101E1X0C1C1100C1
1C1C00X0111X0001
10C000C00C10C011
111001111110X001
101X01CX00C00001
1010C10001101101
1110010C0X000C01
10C0111E0C0C0X01
11100CX011110001
1C0CX000C0X00C01
1111111111111111