11111111111111111111
100P1C00C000C00C00C1
1C1110X1111111111101
100C10C0P0C000C1XC01
1X001111111110X11101
10C0C00X00C00C0X00C1
1000XC00C1111111C111
1C10C001E00C00C1C0C1
10C00XC1C0111X011111
10X01C01X0CX0C000XC1
1C10C0C1110C01C10C01
11111111111111111111